# Syntax Coloring Map For Sigscoper

# Datatypes (KEYWORD1)
Sigscoper	KEYWORD1
SigscoperConfig	KEYWORD1
SigscoperStats	KEYWORD1
TriggerMode	KEYWORD1

# Methods and Functions (KEYWORD2)
start	KEYWORD2
stop	KEYWORD2
restart	KEYWORD2
is_running	KEYWORD2
is_ready	KEYWORD2
is_trigger_fired	KEYWORD2
get_stats	KEYWORD2
get_buffer	KEYWORD2
get_trigger_threshold	KEYWORD2
get_max_channels	KEYWORD2

# Constants (LITERAL1)
FREE	LITERAL1
AUTO_RISE	LITERAL1
AUTO_FALL	LITERAL1
FIXED_RISE	LITERAL1
FIXED_FALL	LITERAL1
MAX_CHANNELS	LITERAL1
SIGNAL_BUFFER_SIZE	LITERAL1
TRIGGER_POSITON	LITERAL1
MEDIAN_FILTER_WINDOW	LITERAL1
SAMPLE_RATE	LITERAL1 